MyFirstMaze
#
1,1,4,8
# ############
# ############
#  ###########
##  ##########
###  #########
##### ########
####  ########
#### #########
#### #########
#### #########
